0 0 0 0 0 0 0 0 0 0 0 0 0 0 0 0 0 0 0 0 0 0 0 0 0 0 0 0 0 0 0 0 0 0 0 0 0 0 0 0 0 0 0 0 0 0 0 0 0 0 
0 0 0 0 0 0 0 0 0 0 0 0 0 0 0 0 0 0 0 0 0 0 0 0 0 0 0 0 0 0 0 0 0 0 0 0 0 0 0 0 0 0 0 0 0 0 0 0 0 0 
0 0 0 0 0 0 0 0 0 0 0 0 0 0 0 0 0 0 0 0 0 0 0 0 0 0 0 0 0 0 0 0 0 0 0 0 0 0 0 0 0 0 0 0 0 0 0 0 0 0 
0 0 0 0 0 0 0 0 0 0 0 0 0 0 0 0 0 0 0 0 0 0 0 0 0 0 0 0 0 0 0 0 0 0 0 0 0 0 0 0 0 0 0 0 0 0 0 0 0 0 
0 0 0 0 0 0 0 0 0 0 0 0 0 0 0 0 0 0 0 0 0 0 0 0 0 0 0 0 0 0 0 0 0 0 0 0 0 0 0 0 0 0 0 0 0 0 0 0 0 0 
0 0 0 0 0 0 0 0 0 0 0 0 0 0 0 0 0 0 0 0 0 0 0 0 0 0 0 0 0 0 0 0 0 0 0 0 0 0 0 0 0 0 0 0 0 0 0 0 0 0 
0 0 0 0 0 0 0 32 32 32 32 32 32 32 32 32 32 32 32 32 32 32 32 32 32 32 32 32 32 32 32 32 32 32 32 32 32 32 32 32 32 32 32 0 0 0 0 0 0 0 
0 0 0 0 0 0 0 32 36 38 32 32 32 32 32 32 32 32 32 32 32 32 32 32 32 32 32 32 32 32 32 32 32 32 32 32 32 32 32 32 32 32 32 0 0 0 0 0 0 0 
0 0 0 0 0 0 0 32 38 38 32 32 32 32 32 38 38 38 38 38 38 32 32 32 32 32 32 32 32 32 32 38 38 38 38 38 38 32 32 32 32 32 32 0 0 0 0 0 0 0 
0 0 0 0 0 0 0 32 32 38 32 32 32 32 38 38 38 38 38 38 38 38 32 32 32 32 32 32 32 32 38 38 38 38 32 32 38 32 32 32 32 32 32 0 0 0 0 0 0 0 
0 0 0 0 0 0 0 32 32 38 38 38 38 38 38 38 38 38 38 38 38 38 32 32 32 32 38 38 38 38 38 38 38 32 32 32 38 38 32 32 32 32 32 0 0 0 0 0 0 0 
0 0 0 0 0 0 0 32 32 32 32 32 32 32 38 38 38 38 38 38 38 38 32 32 32 38 38 38 38 38 38 38 32 32 32 32 32 38 32 32 32 32 32 0 0 0 0 0 0 0 
0 0 0 0 0 0 0 32 32 32 32 32 32 32 32 38 38 38 38 38 38 32 32 32 38 38 38 38 38 38 32 32 32 32 32 32 32 38 38 32 32 32 32 0 0 0 0 0 0 0 
0 0 0 0 0 0 0 32 32 32 32 32 32 32 32 32 32 32 38 32 32 32 32 38 38 38 38 32 32 32 32 32 32 32 32 32 38 38 38 38 32 32 32 0 0 0 0 0 0 0 
0 0 0 0 0 0 0 32 32 32 32 32 32 32 32 32 32 32 38 32 32 32 38 38 38 32 32 32 32 32 32 32 32 32 32 38 38 38 38 38 32 32 32 0 0 0 0 0 0 0 
0 0 0 0 0 0 0 32 32 32 32 32 32 32 32 38 38 38 38 38 32 32 38 38 38 32 32 38 32 32 32 32 32 32 32 38 38 38 38 38 38 32 32 0 0 0 0 0 0 0 
0 0 0 0 0 0 0 32 32 32 32 32 32 38 38 38 32 38 38 38 32 32 38 32 32 32 32 38 32 32 32 32 32 32 38 38 38 38 38 38 38 32 32 0 0 0 0 0 0 0 
0 0 0 0 0 0 0 32 38 38 32 32 32 32 32 32 32 32 38 32 32 32 38 32 32 38 38 38 38 38 32 32 38 38 38 32 32 38 38 38 32 32 32 0 0 0 0 0 0 0 
0 0 0 0 0 0 0 32 38 38 38 38 38 32 32 32 32 32 38 32 32 32 38 32 32 38 38 38 38 38 32 38 38 32 32 32 32 32 38 32 32 32 32 0 0 0 0 0 0 0 
0 0 0 0 0 0 0 32 38 38 38 38 38 32 32 32 32 32 38 32 32 32 38 32 32 38 38 38 38 38 38 38 32 32 32 32 32 32 38 32 32 32 32 0 0 0 0 0 0 0 
0 0 0 0 0 0 0 32 38 38 38 38 38 32 32 32 32 32 38 32 32 32 38 32 32 32 38 38 38 38 32 32 32 32 32 32 32 32 38 32 32 32 32 0 0 0 0 0 0 0 
0 0 0 0 0 0 0 32 38 38 38 38 38 32 32 32 32 32 38 32 32 32 38 38 32 32 32 32 32 32 32 32 32 32 32 32 32 32 38 32 32 32 32 0 0 0 0 0 0 0 
0 0 0 0 0 0 0 32 32 32 38 32 32 32 32 32 32 32 38 32 38 38 38 38 32 32 32 32 32 32 32 32 32 32 32 32 32 32 38 32 32 32 32 0 0 0 0 0 0 0 
0 0 0 0 0 0 0 32 32 32 38 32 32 32 32 32 32 32 38 32 32 32 32 32 32 32 32 32 32 32 32 32 32 32 32 32 32 38 38 38 38 32 32 0 0 0 0 0 0 0 
0 0 0 0 0 0 0 32 32 32 38 32 32 32 38 38 38 38 38 38 38 38 32 32 32 32 32 32 32 32 32 32 32 32 38 38 38 38 38 38 38 32 32 0 0 0 0 0 0 0 
0 0 0 0 0 0 0 32 32 32 38 32 32 38 38 38 38 38 38 38 38 38 38 32 32 32 32 32 32 32 32 32 38 38 38 38 38 38 38 38 38 32 32 0 0 0 0 0 0 0 
0 0 0 0 0 0 0 32 32 32 38 38 38 38 38 38 38 38 38 38 38 38 38 32 32 32 32 32 32 32 32 32 38 38 38 38 38 38 38 38 38 32 32 0 0 0 0 0 0 0 
0 0 0 0 0 0 0 32 32 32 38 38 38 38 38 38 38 38 38 38 38 38 38 32 32 32 32 32 32 32 32 32 38 38 38 38 38 38 38 38 38 32 32 0 0 0 0 0 0 0 
0 0 0 0 0 0 0 32 32 32 32 32 32 32 38 38 38 38 38 38 38 38 38 38 38 38 38 38 38 38 38 38 38 38 38 38 38 32 32 38 38 32 32 0 0 0 0 0 0 0 
0 0 0 0 0 0 0 32 32 32 32 32 32 32 32 32 32 38 38 32 32 32 32 32 32 32 38 32 32 32 32 32 38 38 38 32 32 32 32 38 38 32 32 0 0 0 0 0 0 0 
0 0 0 0 0 0 0 32 32 32 32 32 32 32 32 32 32 38 38 32 32 32 32 32 32 32 38 32 32 32 32 32 32 32 32 32 32 32 38 38 38 32 32 0 0 0 0 0 0 0 
0 0 0 0 0 0 0 32 32 32 32 32 32 32 32 32 32 38 38 32 32 32 32 32 32 32 38 32 32 32 32 32 32 32 32 32 32 32 32 38 38 32 32 0 0 0 0 0 0 0 
0 0 0 0 0 0 0 32 32 32 32 32 32 32 32 32 32 38 38 32 32 32 32 32 32 32 38 32 32 32 32 32 32 32 32 32 32 32 32 32 32 32 32 0 0 0 0 0 0 0 
0 0 0 0 0 0 0 32 32 32 32 32 32 32 32 32 32 38 38 32 32 32 32 32 32 38 38 38 32 32 32 32 32 32 32 32 32 32 32 32 32 32 32 0 0 0 0 0 0 0 
0 0 0 0 0 0 0 32 32 32 32 32 32 32 32 32 32 38 38 32 32 32 32 32 32 38 38 38 32 32 32 32 32 32 32 32 32 32 32 32 32 32 32 0 0 0 0 0 0 0 
0 0 0 0 0 0 0 32 32 32 32 32 32 32 32 38 38 38 38 38 38 32 32 32 32 32 32 32 32 32 32 32 32 32 32 32 32 32 32 32 32 32 32 0 0 0 0 0 0 0 
0 0 0 0 0 0 0 32 32 32 32 32 32 32 32 38 38 38 38 38 38 32 32 32 32 32 32 32 32 32 32 32 32 32 32 32 32 32 32 32 32 32 32 0 0 0 0 0 0 0 
0 0 0 0 0 0 0 32 32 38 38 38 38 38 38 38 38 38 38 38 38 32 32 32 32 32 32 32 32 32 32 32 32 32 32 32 38 38 38 38 38 32 32 0 0 0 0 0 0 0 
0 0 0 0 0 0 0 32 32 38 32 32 32 32 32 38 38 38 38 38 38 32 32 32 32 32 32 32 32 32 32 32 38 38 38 38 38 38 32 32 38 32 32 0 0 0 0 0 0 0 
0 0 0 0 0 0 0 32 32 38 32 32 32 32 32 38 38 38 38 38 38 32 32 32 32 32 32 32 32 32 32 38 38 38 38 38 38 32 32 32 38 32 32 0 0 0 0 0 0 0 
0 0 0 0 0 0 0 32 38 38 38 32 32 32 32 38 38 38 38 38 38 38 38 38 38 38 38 38 38 38 38 38 38 38 38 38 38 32 32 32 38 32 32 0 0 0 0 0 0 0 
0 0 0 0 0 0 0 32 38 37 38 32 32 32 32 32 32 32 32 32 32 32 32 32 32 32 32 32 32 32 32 32 38 38 38 38 38 32 32 32 38 32 32 0 0 0 0 0 0 0 
0 0 0 0 0 0 0 32 38 38 38 32 32 32 32 32 32 32 32 32 32 32 32 32 32 32 32 32 32 32 32 32 32 32 32 32 32 32 32 32 32 32 32 0 0 0 0 0 0 0 
0 0 0 0 0 0 0 32 32 32 32 32 32 32 32 32 32 32 32 32 32 32 32 32 32 32 32 32 32 32 32 32 32 32 32 32 32 32 32 32 32 32 32 0 0 0 0 0 0 0 
0 0 0 0 0 0 0 0 0 0 0 0 0 0 0 0 0 0 0 0 0 0 0 0 0 0 0 0 0 0 0 0 0 0 0 0 0 0 0 0 0 0 0 0 0 0 0 0 0 0 
0 0 0 0 0 0 0 0 0 0 0 0 0 0 0 0 0 0 0 0 0 0 0 0 0 0 0 0 0 0 0 0 0 0 0 0 0 0 0 0 0 0 0 0 0 0 0 0 0 0 
0 0 0 0 0 0 0 0 0 0 0 0 0 0 0 0 0 0 0 0 0 0 0 0 0 0 0 0 0 0 0 0 0 0 0 0 0 0 0 0 0 0 0 0 0 0 0 0 0 0 
0 0 0 0 0 0 0 0 0 0 0 0 0 0 0 0 0 0 0 0 0 0 0 0 0 0 0 0 0 0 0 0 0 0 0 0 0 0 0 0 0 0 0 0 0 0 0 0 0 0 
0 0 0 0 0 0 0 0 0 0 0 0 0 0 0 0 0 0 0 0 0 0 0 0 0 0 0 0 0 0 0 0 0 0 0 0 0 0 0 0 0 0 0 0 0 0 0 0 0 0 
0 0 0 0 0 0 0 0 0 0 0 0 0 0 0 0 0 0 0 0 0 0 0 0 0 0 0 0 0 0 0 0 0 0 0 0 0 0 0 0 0 0 0 0 0 0 0 0 0 0 
