12 12 12 12 12 12 12 12 12 12 12 12 12 12 12 12 12 12 12 12 12 12 12 12 12 12 12 12 12 12 12 12 12 12 12 12 12 12 12 12 12 12 12 12 12 12 12 12 12 12
12 12 12 12 12 12 12 12 12 12 12 12 12 12 13 12 12 12 12 12 12 12 12 12 12 12 12 12 12 12 12 12 12 12 12 12 12 12 12 12 12 12 12 12 12 12 12 12 12 12
12 12 12 12 12 12 12 13 12 12 12 12 12 12 12 12 12 12 12 12 12 12 12 12 12 13 12 12 12 12 12 12 12 13 12 12 12 12 12 12 12 12 12 12 12 12 12 12 12 12
12 12 12 12 13 12 12 12 12 12 12 13 12 12 12 12 12 12 13 12 12 12 12 12 12 12 12 13 12 12 12 12 12 12 12 12 12 12 12 12 12 13 12 12 12 12 12 12 12 12
12 12 12 12 12 12 12 12 12 13 12 12 12 12 12 13 12 12 12 12 12 12 12 13 12 12 12 12 12 12 12 13 12 12 13 12 12 12 13 12 12 12 12 12 12 12 12 12 12 12
12 12 12 12 12 12 12 12 12 12 12 12 12 12 12 12 12 12 12 12 12 13 12 12 12 12 12 12 12 13 12 12 12 12 12 12 13 12 12 12 12 12 12 13 12 12 12 12 12 12
12 12 12 12 12 12 12 13 22 20 20 20 20 20 20 20 23 12 22 20 20 20 20 20 20 20 20 23 12 12 12 22 20 20 20 20 20 20 20 20 20 20 23 12 12 12 12 12 12 12
12 12 12 12 12 12 12 12 18 41 40 40 40 40 40 41 19 20 21 41 43 43 11 43 43 43 43 19 20 20 20 21 41 43 35 33 33 33 33 33 33 36 17 12 12 13 12 12 12 12
12 12 13 12 12 12 12 12 18 41 40 39 39 39 40 41 41 41 41 41 43 14 15 15 15 16 43 41 41 41 41 41 41 41 31 26 26 26 26 26 26 30 17 12 12 12 12 12 12 12
12 12 12 12 12 12 12 12 18 41 40 39 39 39 40 41 41 41 41 41 43 17 12 12 12 18 43 41 41 41 41 41 41 41 31 26 26 26 26 26 26 30 17 12 12 12 12 12 12 12
12 12 12 13 12 12 12 12 18 41 40 39 39 39 40 41 41 41 41 41 43 17 12 12 12 18 11 41 41 41 41 41 41 41 31 26 26 26 26 26 26 30 17 12 13 12 12 12 12 12
12 12 12 12 13 12 12 12 18 41 40 39 39 39 40 41 41 41 41 41 43 19 20 20 20 21 43 41 41 41 41 41 41 41 31 26 26 26 26 26 26 30 17 12 12 12 12 12 12 12
12 12 12 12 12 12 12 12 18 41 40 40 39 40 40 41 41 41 41 41 11 43 35 33 36 43 43 43 43 43 43 43 43 43 37 28 28 29 26 27 28 38 17 13 12 12 12 12 12 12
12 12 12 12 12 12 12 12 18 41 41 41 43 41 41 41 41 41 41 41 41 41 31 26 30 41 41 41 41 41 41 41 41 41 41 41 41 31 26 30 14 15 25 12 12 12 12 12 12 12
12 12 12 12 13 12 12 12 24 16 41 41 43 41 41 41 41 41 41 41 41 41 31 26 30 41 41 41 41 41 41 41 41 41 41 41 41 31 26 30 17 12 12 12 12 13 12 12 12 12
12 12 12 12 12 12 12 12 12 18 41 41 43 41 41 41 41 41 41 41 41 41 31 26 30 41 41 41 41 41 41 41 41 41 41 41 41 31 26 30 17 12 12 12 12 12 12 12 12 12
12 12 12 12 12 12 12 12 22 21 41 41 43 41 41 41 41 41 41 41 41 41 31 26 30 43 43 43 41 41 41 41 41 41 41 41 41 31 26 30 17 12 12 12 12 12 13 12 12 12
12 12 13 12 12 12 12 22 21 41 41 41 43 41 41 41 41 41 41 41 41 41 31 26 30 41 41 41 41 41 41 41 41 41 41 35 33 34 26 30 17 12 12 13 12 12 12 12 12 12
12 12 12 12 12 12 12 18 41 41 43 43 43 41 41 41 41 41 41 41 41 41 31 26 30 41 41 41 41 41 41 41 41 41 41 31 26 26 26 30 17 12 12 12 12 12 12 12 12 12
12 12 12 13 12 12 12 18 41 41 43 41 41 41 41 41 41 41 41 41 41 43 31 26 30 43 41 41 41 41 41 41 41 41 41 31 26 27 28 38 17 12 13 12 12 12 12 12 12 12
12 12 12 12 12 12 12 18 41 41 43 41 41 43 35 33 33 33 33 33 33 33 34 26 32 33 33 33 33 36 41 41 41 35 33 34 26 30 43 41 17 12 12 12 12 12 12 12 12 12
12 12 12 12 12 13 12 18 41 41 43 41 41 11 31 26 26 26 26 26 26 26 26 26 26 26 26 26 26 30 43 43 43 31 26 26 26 30 43 14 25 12 12 12 12 12 12 12 12 12
12 12 12 12 12 12 13 18 41 41 43 41 41 43 37 28 28 28 28 28 28 28 29 26 27 28 28 28 28 38 41 41 41 37 28 29 26 30 43 17 12 13 12 12 12 12 12 12 12 12
12 12 12 12 12 12 12 24 16 41 43 41 41 43 41 41 41 41 41 41 41 43 31 26 30 43 41 41 41 41 41 41 41 41 41 31 26 30 43 17 12 12 12 12 13 12 12 12 12 12
12 12 12 12 12 12 12 12 18 41 43 41 41 43 41 41 41 41 41 41 41 41 31 26 30 41 41 41 41 41 41 41 41 41 41 31 26 30 11 17 12 12 12 12 12 12 12 12 12 12
12 12 12 12 12 13 12 22 21 41 43 41 41 43 43 41 41 41 41 41 41 41 31 26 30 41 41 41 41 41 41 41 41 41 41 31 26 30 43 17 12 12 12 13 12 12 12 12 12 12
12 12 12 12 12 12 12 18 41 41 43 41 41 41 43 41 41 41 41 41 41 41 31 26 30 41 41 41 41 41 41 41 41 41 41 31 26 30 43 17 12 12 12 12 12 12 12 12 12 12
12 12 12 13 12 12 12 18 41 41 43 41 41 41 43 41 41 41 41 41 41 41 31 26 30 43 43 43 41 41 41 41 41 41 41 31 26 30 43 17 12 13 12 12 12 12 12 12 12 12
12 12 12 12 12 12 12 18 41 41 43 41 41 41 43 41 41 41 41 41 41 41 31 26 30 41 41 43 41 41 43 41 41 41 41 31 26 30 43 17 12 12 12 12 12 12 12 12 12 12
12 12 12 12 12 12 13 18 41 41 43 43 43 43 43 43 41 41 41 41 41 41 31 26 30 41 41 43 41 41 43 41 41 41 41 37 28 38 43 17 12 12 12 12 13 12 12 12 12 12
12 12 12 12 12 12 12 18 41 41 11 43 43 43 43 43 41 41 41 41 41 41 31 26 30 41 41 43 43 43 43 41 41 41 41 41 43 41 14 25 12 12 13 12 12 12 12 12 12 12
12 12 12 12 12 12 12 24 16 41 43 43 43 43 43 43 41 41 41 41 41 41 31 26 30 41 41 41 41 41 41 41 41 41 41 43 43 43 17 12 12 12 12 12 12 12 12 12 12 12
12 12 12 12 12 13 12 12 18 41 43 43 43 11 43 43 41 41 41 41 41 41 31 26 30 41 41 41 41 41 41 41 41 41 41 43 43 43 17 12 12 12 12 12 12 12 13 12 12 12
12 12 12 12 12 12 12 12 18 41 43 43 43 43 43 43 41 41 41 41 41 41 31 26 30 41 41 41 41 41 41 41 41 41 41 43 43 11 17 12 12 13 12 12 12 12 12 12 12 12
12 12 12 12 12 12 12 12 18 41 43 43 43 43 43 43 41 41 41 41 41 41 31 26 30 41 41 41 41 41 41 41 41 41 41 43 43 43 17 12 12 12 12 12 12 12 12 12 12 12
12 12 12 12 13 12 12 22 21 41 41 41 41 41 41 41 41 41 41 41 41 41 37 28 38 41 41 41 41 41 41 41 41 41 41 11 43 43 19 23 12 12 12 12 12 12 12 12 12 12
12 12 12 12 12 12 12 18 41 41 41 41 41 41 41 41 41 41 41 41 43 43 43 43 43 43 43 41 41 41 41 41 41 41 43 43 43 43 43 19 23 12 12 12 13 12 12 12 12 12
12 12 12 12 12 12 13 18 41 41 41 41 41 41 41 41 41 41 41 43 43 43 43 43 43 43 43 43 41 41 43 41 41 43 43 43 43 43 43 43 17 12 12 12 12 12 12 12 12 12
12 12 12 12 12 12 12 18 41 41 41 41 41 41 41 41 41 41 41 11 43 43 43 43 43 11 43 43 41 41 41 41 43 43 43 43 43 11 43 43 17 12 13 12 12 12 12 12 12 12
12 12 12 12 12 12 12 18 41 41 42 41 41 41 41 41 41 41 41 43 11 43 43 43 43 43 43 43 43 41 41 41 43 43 43 43 43 41 43 43 17 12 12 12 12 12 12 12 12 12
12 12 13 12 12 12 12 18 41 41 43 41 41 43 43 43 43 43 43 43 43 43 43 43 43 43 43 43 43 43 43 43 43 43 41 43 43 43 43 43 17 12 12 12 12 13 12 12 12 12
12 12 12 12 12 12 12 18 41 41 43 43 43 43 41 14 15 15 16 43 43 43 43 43 11 43 43 14 15 15 16 43 43 43 43 43 43 43 11 43 17 12 12 12 12 12 12 13 12 12
12 12 12 12 12 12 12 18 41 41 41 41 41 41 14 25 12 12 24 16 43 43 43 43 43 43 14 25 12 12 18 43 43 41 43 43 41 43 43 43 17 12 12 12 12 12 12 12 12 12
12 12 12 12 13 12 12 24 15 15 15 15 15 15 25 12 12 12 12 24 15 15 15 15 15 15 25 12 13 12 24 16 43 11 43 43 43 43 14 15 25 12 13 12 12 12 12 12 12 12
12 12 12 12 12 12 12 12 12 12 12 12 12 12 12 12 12 12 13 12 12 12 12 12 12 12 12 12 12 12 12 24 15 15 15 15 15 15 25 12 12 12 12 12 12 12 13 12 12 12
12 12 12 12 12 12 12 12 12 12 12 13 12 12 12 12 13 12 12 12 12 12 12 12 12 12 12 12 12 12 12 12 12 12 12 12 13 12 12 12 12 12 12 13 12 12 12 12 12 12
12 12 12 12 12 12 13 12 12 12 12 12 12 12 12 12 12 12 12 12 12 12 12 12 13 12 12 12 12 13 12 12 12 12 12 12 12 12 12 12 12 12 12 12 12 12 12 12 12 12
12 12 12 12 12 12 12 12 12 12 12 12 12 12 13 12 12 12 12 12 13 12 12 12 12 12 12 12 12 12 12 12 13 12 12 12 12 12 12 13 12 12 12 12 12 12 12 12 12 12
12 12 12 12 12 12 12 12 12 12 12 12 12 12 12 12 12 12 12 12 12 12 12 12 12 12 12 13 12 12 12 12 12 12 12 12 12 12 12 12 12 12 12 12 12 13 12 12 12 12
12 12 12 12 12 12 12 12 12 12 12 12 12 12 12 12 12 12 12 12 12 12 12 12 12 12 12 12 12 12 12 12 12 12 12 12 12 12 12 12 12 12 12 12 12 12 12 12 12 12